rows 50
cols 50
players 2
%%%%%%%%%%%%%%%%%%%%%%%%%%%%%%%%%%%%%%%%%%%%%%%%%%
%......................%%%.......................%
%.1....................%%%.....................2.%
%......................%%%.......................%
%......................%%%.......................%
%......................%%%.......................%
%......................%%%.......................%
%......................%%%.......................%
%......................%%%.......................%
%................................................%
%................................................%
%................................................%
%................................................%
%................................................%
%%%%%%%%%%%%%%....................%%%%%%%%%%%%%%%%
%%%%%%%%%%%%%%....................%%%%%%%%%%%%%%%%
%................................................%
%................................................%
%................................................%
%................................................%
%................................................%
%................................................%
%................................................%
%..................%%%%%%%%%%....................%
%..................%%%%%%%%%%....................%
%..................%%%%%%%%%%....................%
%................................................%
%................................................%
%................................................%
%................................................%
%................................................%
%................................................%
%................................................%
%%%%%%%%%%%%%%....................%%%%%%%%%%%%%%%%
%%%%%%%%%%%%%%....................%%%%%%%%%%%%%%%%
%................................................%
%................................................%
%................................................%
%................................................%
%................................................%
%................................................%
%................................................%
%......................%%%.......................%
%......................%%%.......................%
%......................%%%.......................%
%......................%%%.......................%
%......................%%%.......................%
%.1....................%%%.....................2.%
%......................%%%.......................%
%%%%%%%%%%%%%%%%%%%%%%%%%%%%%%%%%%%%%%%%%%%%%%%%%%
