rows 96
cols 96
players 2
%%%%%%%%%%%%%%%%%%%%%%%%%%%%%%%%%%%%%%%%%%%%%%%%%%%%%%%%%%%%%%%%%%%%%%%%%%%%%%%%%%%%%%%%%%%%%%%%
%.........%%%%%%%%%%......%%%.....................%%.............%%%%.............%%...........%
%.........%%%%%%%%%%%.....%%.....................%%%%............%%%.............%%%%..........%
%%.%%.....%%%%%%%%%%%.....%%%......%.....%.......%%%%......%%%%%%%%%.........%.%%%%%.....%.....%
%%%%%....%%%%%%%%%%%%....%%%......%%......%%......%%......%%%%%%%%%%%....%%%%%%%%%%%%.....%%%..%
%%%%%.....%%%%%%%%%%%....%%%%....%%%......%%.....%%%......%%%%%%%%%%%.....%%%%%%%%%%......%%%..%
%%..%....%.%%%.%%%%%.....%%%......%%%.....%%%.....%%......%%%%..%.%%.....%..%%%%.%..%......%...%
%................%%%%............%%%.....%%%...................................................%
%................%%%%............%%%.....%%%...................................................%
%.................%%%.............%%%.....%%...................................................%
%.................%%%............%%%%....%%%%..................................................%
%%%%%.....%......%%%%%%%%%.%%....%%%.....%%%%....%%%%%%%%.%..%%%...%%....%.%.%...%..%.%.%%.%%..%
%%%%......%%%....%%%%%%%%%%%......%%......%%......%%%%%%%%%%%%%%%%%%.....%%%%%%%%%%%%%%%%%%%%..%
%%%%%.....%%.....%%%%%%%%%%%%....%%%%.....%%......%%%%%%%%%%%%%%%%%%.....%%%%%%%%%%%%%%%%%%%...%
%%%%%....%%%.....%%%.%.%%%%%......%%%.....%%%....%%%%.%%%%.%%%.%%........%%%%..%%%%%%%..%..%%..%
%%%%.....................%%%%.............%%%....%%%%....................%%%.1....%%...........%
%%%%.....................%%%%.............%%.....%%%%....................%%%.....%%%...........%
%%%%%....................%%%%............%%%.....%%%.....................%%%......%%...........%
%%%%.....................%%%%............%%%.....%%%%.....................%%.....%%%...........%
%%%%%....%%.......%%%.....%%%%%%%%.%.....%%%%....%%%%....%.%.....%.%...%%%%%%.....%%%......%%..%
%%%%......%%%.....%%......%%%%%%%%%%......%%%....%%%%....%%%%....%%%%%%%%%%%......%%......%%...%
%%%%.....%%%%.....%%%.....%%%%%%%%%%%.....%%%....%%%%....%%%.....%%%%%%%%%%%%....%%%.....%%%%..%
%%%%......%%%......%......%.%...%%%%........%....%.........%%.....%.%%%.%.%%......%%.....%%....%
%%%%%....%%%%....................%%%%.............................................%%...........%
%%%%%....%%%%....2...............%%%%.............................................%%...........%
%%%%.....%%%.....................%%%%.............................................%%%..........%
%%%%%....%%%......................%%%............................................%%%...........%
%%%%%%%%%%%%.....%.%.%%..%%%..%%.%%%%%%%%%.%........%....%..%.%%.%%......%.%.....%%%%..%.%%.%..%
%%%%%%%%%%%%%.....%%%%%%%%%%%%%%%%%%%%%%%%%%%....%%%%....%%%%%%%%%%%%....%%%.....%%%%%%%%%%%...%
%%%%%%%%%%%%%.....%%%%%%%%%%%%%%%%%%%%%%%%%%%....%%%.....%%%%%%%%%%%......%%%....%%%%%%%%%%%...%
%%%%%.%%.%........%%%%.%.%%%%%.%%.%..%%%.%%%.....%%%......%%%%.%%.%%%......%%.....%%%.....%.%..%
%%%%%.............%%%....................%%%%....%%%......%%.....................%%%%..........%
%%%%.............%%%%....................%%%%....%%%......%%.....................%%%...........%
%%%%%.............%%......................%%%....%%%......%%%.....................%%...........%
%%%%.............%%%%.....................%%%....%%%%.....%%.....................%%%%..........%
%%%%.........%.%%%%%.....%.......%.%%.....%%%%%%%%%%%.....%%%......%.....%.......%%%%......%%%%%
%%%%%....%%%%%%%%%%%%.....%%%....%%%%....%%%%%%%%%%%%....%%%......%%......%%......%%......%%%%%%
%%%%%.....%%%%%%%%%%......%%%.....%%%.....%%%%%%%%%%%....%%%%....%%%......%%.....%%%......%%%%%%
%.%%.....%..%%%%.%..%......%.....%..%....%.%%%.%%%%%.....%%%......%%%.....%%%.....%%......%%%%.%
%................................................%%%%............%%%.....%%%...................%
%................................................%%%%............%%%.....%%%...................%
%.................................................%%%.............%%%.....%%...................%
%.................................................%%%............%%%%....%%%%..................%
%..%%....%.%.%...%..%.%.%%.%%....%%%%.....%......%%%%%%%%%.%%....%%%.....%%%%....%%%%%%%%.%..%%%
%%%%.....%%%%%%%%%%%%%%%%%%%%.....%%......%%%....%%%%%%%%%%%......%%......%%......%%%%%%%%%%%%%%
%%%%.....%%%%%%%%%%%%%%%%%%%.....%%%%.....%%.....%%%%%%%%%%%%....%%%%.....%%......%%%%%%%%%%%%%%
%........%%%%..%%%%%%%..%..%%....%%%%....%%%.....%%%.%.%%%%%......%%%.....%%%....%%%%.%%%%.%%%.%
%........%%%.2....%%..............%%.....................%%%%.............%%%....%%%%..........%
%........%%%.....%%%..............%%.....................%%%%.............%%.....%%%%..........%
%........%%%......%%.............%%%%....................%%%%............%%%.....%%%...........%
%.........%%.....%%%.............%%%.....................%%%%............%%%.....%%%%..........%
%%.%...%%%%%%.....%%%......%%.....%%%....%%.......%%%.....%%%%%%%%.%.....%%%%....%%%%....%.%...%
%%%%%%%%%%%%......%%......%%.....%%%......%%%.....%%......%%%%%%%%%%......%%%....%%%%....%%%%..%
%%%%%%%%%%%%%....%%%.....%%%%....%%%.....%%%%.....%%%.....%%%%%%%%%%%.....%%%....%%%%....%%%...%
%.%.%%%.%.%%......%%.....%%.......%%......%%%......%......%.%...%%%%........%....%.........%%..%
%.................%%.............%%%%....%%%%....................%%%%..........................%
%.................%%..............%%%....%%%%....................%%%%..........................%
%.................%%%.............%%.....%%%.....................%%%%..........................%
%................%%%..............%%%....%%%......................%%%..........................%
%%%......%.%.....%%%%..%.%%.%.....%%%%%%%%%%.....%.%.%%..%%%..%%.%%%%%%%%%.%........%....%..%.%%
%%%%%....%%%.....%%%%%%%%%%%.....%%%%%%%%%%%%.....%%%%%%%%%%%%%%%%%%%%%%%%%%%....%%%%....%%%%%%%
%%%%......%%%....%%%%%%%%%%%......%%%%%%%%%%%.....%%%%%%%%%%%%%%%%%%%%%%%%%%%....%%%.....%%%%%%%
%.%%%......%%.....%%%.....%.%....%%%%.%%.%........%%%%.%.%%%%%.%%.%..%%%.%%%.....%%%......%%%%.%
%................%%%%............%%%%.............%%%....................%%%%....%%%......%%...%
%................%%%.............%%%.............%%%%....................%%%%....%%%......%%...%
%.................%%.............%%%%.............%%......................%%%....%%%......%%%..%
%................%%%%............%%%.............%%%%.....................%%%....%%%%.....%%...%
%..%.....%.......%%%%......%%%%%%%%%.........%.%%%%%.....%.......%.%%.....%%%%%%%%%%%.....%%%..%
%.%%......%%......%%......%%%%%%%%%%%....%%%%%%%%%%%%.....%%%....%%%%....%%%%%%%%%%%%....%%%...%
%%%%......%%.....%%%......%%%%%%%%%%%.....%%%%%%%%%%......%%%.....%%%.....%%%%%%%%%%%....%%%%..%
%%%%%.....%%%.....%%......%%%%..%.%%.....%..%%%%.%..%......%.....%..%....%.%%%.%%%%%.....%%%...%
%%%%.....%%%.....................................................................%%%%..........%
%%%%.....%%%....................................................1................%%%%..........%
%%%%%.....%%......................................................................%%%..........%
%%%%%....%%%%.....................................................................%%%..........%
%%%%.....%%%%....%%%%%%%%.%..%%%...%%....%.%.%...%..%.%.%%.%%....%%%%.....%......%%%%%%%%%.%%..%
%%%%......%%......%%%%%%%%%%%%%%%%%%.....%%%%%%%%%%%%%%%%%%%%.....%%......%%%....%%%%%%%%%%%...%
%%%%%.....%%......%%%%%%%%%%%%%%%%%%.....%%%%%%%%%%%%%%%%%%%.....%%%%.....%%.....%%%%%%%%%%%%..%
%.%%%.....%%%....%%%%.%%%%.%%%.%%........%%%%..%%%%%%%..%..%%....%%%%....%%%.....%%%.%.%%%%%...%
%.........%%%....%%%%....................%%%.0....%%..............%%.....................%%%%..%
%.........%%.....%%%%....................%%%.....%%%..............%%.....................%%%%..%
%........%%%.....%%%.....................%%%......%%.............%%%%....................%%%%..%
%........%%%.....%%%%.....................%%.....%%%.............%%%.....................%%%%..%
%%.%.....%%%%....%%%%....%.%.....%.%...%%%%%%.....%%%......%%.....%%%....%%.......%%%.....%%%%%%
%%%%......%%%....%%%%....%%%%....%%%%%%%%%%%......%%......%%.....%%%......%%%.....%%......%%%%%%
%%%%%.....%%%....%%%%....%%%.....%%%%%%%%%%%%....%%%.....%%%%....%%%.....%%%%.....%%%.....%%%%%%
%%%%........%....%.........%%.....%.%%%.%.%%......%%.....%%.......%%......%%%......%......%.%..%
%%%%%.............................................%%.............%%%%....%%%%..................%
%%%%%.............................................%%..............%%%....%%%%..................%
%%%%%.............................................%%%.............%%.....%%%...................%
%%%%%............................................%%%..............%%%....%%%...................%
%%%%%%%%%%.%........%....%..%.%%.%%......%.%.....%%%%..%.%%.%.....%%%%%%%%%%.....%.%.%%..%%%..%%
%%%%%%%%%%%%%....%%%%....%%%%%%%%%%%%....%%%.....%%%%%%%%%%%.....%%%%%%%%%%%%.....%%%%%%%%%%%%%%
%%%%%%%%%%%%%....%%%.....%%%%%%%%%%%......%%%....%%%%%%%%%%%......%%%%%%%%%%%.....%%%%%%%%%%%%%%
%%%%%%%%%%%%.....%%%......%%%%%%%%%%%......%%.....%%%%%%%%%%%....%%%%%%%%%........%%%%%%%%%%%%%%
%%%%%%%%%%%%%%%%%%%%%%%%%%%%%%%%%%%%%%%%%%%%%%%%%%%%%%%%%%%%%%%%%%%%%%%%%%%%%%%%%%%%%%%%%%%%%%%%

