rows 5
cols 10
players 2
%%%%%%%%%%
%.....2..%
%++++....%
%1+......%
%%%%%%%%%%
